9.ox
o...AAA..
....AAAo.
...oAAA..
BBB....o.
BBB......
BBB..o...
.oCCC....
..CCC....
..CCC.o..
